3
15 8 
...MS..SSM.....
H..S.M..S....S.
S..M.M.S.......
...............
...............
...............
...............
...............
-----
.SMSM..SSM.....
..HSMM..S......
S.SMS.MS.......
...............
...............
...............
...............
...............
-----
.S.MS..SSM.....
SSS..MS.S......
S.SS.H.MMM.....
...............
...............
...............
...............
...............
-----