3
15 8 
....S..SSM.....
H..S.M....S..S.
S......S.......
...............
...............
...............
...............
...............
-----
.S.SM..SHM.....
..HSM...S......
S.S...MS.....M.
...............
...............
...............
...............
...............
-----
.S.MS..SHM....M
M.SH.MS....SS..
S.SS.H.M....M..
...............
...............
...............
...............
...............
-----