3
10 10 
.S.MS..SSM
H.......S.
S..M.M.S..
.S.S.M.MM.
..........
..........
..........
..........
..........
..........
-----
.SMSM..SSM
..HSMM..S.
S.SMS.MS..
.M..S..MM.
..........
..........
..........
..........
..........
..........
-----
.S.MS..SSM
SSS..MS.S.
S.SS.H.MMM
.MMSS..SS.
..........
..........
..........
..........
..........
..........
