1
10 10
..M.M.....
SS......S.
...S......
..........
..........
-----